type octile
height 49
width 49
map
TTTTTTTTTTTTTTTTTTTTTTTTTTTTTTTTTTTTTTTTTTTTTTTTT
TTT............TTTT.TTT...TTTT.TTTT............TT
TT.............TTT........TTT..TTT.............TT
T........SSSSS..................................T
T........SSSSSS.................................T
T......SSSSSS...................................T
T.......SSSSSS..................................T
T.....SSSS..............TT........SSSSS.........T
T......................TTT........SSSSSSS.......T
T.......SSSSSSS........TTT..........SSSSSS......T
T.......SSSSS........................SSS........T
T.......SSSS.......................SSSSSS.......T
T...............................................T
T...............................................T
T...............................................T
TTT............TTTT............TTTT............TT
TTT............TTTT............TTTT............TT
TTT............TTTT............TTTT............TT
TT.............TTT.............TTT.............TT
TT..............................................T
TT..............................................T
TT.......SSSSSSS................................T
TT..........SSSSSS..............................T
T.........SSSSSS................................T
T...........SSSSSS..............................T
T...............................SSSSSSS.........T
TT.................................SSSSSS.......T
TTT...............................SSSSSS........T
TTT.............................................T
TTT.............................................T
T...............................................T
TTT............TTTT............TTTT............TT
TTT............TTTT............TTTT............TT
TTT............TTTT............TTTT............TT
TT.............TTT.............TTT.............TT
T...............................................T
T...............................................T
T...............................................T
T...............................................T
T...............................................T
T...............................................T
T...............................................T
T...............................................T
T...............................................T
T...............................................T
T...............................................T
T...................TTT...TTT...................T
TTT............TTTT.TTTT..TTTT.TTTT............TT
TTTTTTTTTTTTTTTTTTTTTTTTTTTTTTTTTTTTTTTTTTTTTTTTT
